0000010000000000*
0000010000000000*
0000011000000000*
0000001000000000*
0000001100000000*
0000000100000000*
0000111100000000*
0000100000000000*
0111100000000000*
0111100000000000*